National flags of the all 197 independent countries of the world in alphabetical order
Flag	Country
 	A
Flag of Afghanistan	Afghanistan
Flag of Albania	Albania
Flag of Algeria	Algeria
Flag of Andorra	Andorra
Flag of Angola	Angola
Flag of Antigua & Barbuda	Antigua and Barbuda
Flag of Argentina	Argentina
Flag of Armenia	Armenia
Flag of Australia	Australia
Flag of Austria	Austria
Flag of Azerbaijan	Azerbaijan
 	B
Flag of Bahamas	Bahamas
Flag of Bahrain	Bahrain
Flag of Bangladesh	Bangladesh
Flag of Barbados	Barbados
Flag of Belarus	Belarus
Flag of Belgium	Belgium
Flag of Belize	Belize
Flag of Benin	Benin
Flag of Bhutan	Bhutan
Flag of Bolivia	Bolivia
Flag of Bosnia and Herzegovina	Bosnia and Herzegovina
Flag of Botswana	Botswana
Flag of Brazil	Brazil
Flag of Brunei	Brunei
Flag of Bulgaria	Bulgaria
Flag of Burkina Faso	Burkina Faso
Flag of Burundi	Burundi
 	C
Flag of Cabo Verde	Cabo Verde
Flag of Cambodia	Cambodia
Flag of Cameroon	Cameroon
Flag of Canada	Canada
Flag of Central African Republic	Central African Republic
Flag of Chad	Chad
Flag of Chile	Chile
Flag of China	China
Flag of Colombia	Colombia
Flag of Comoros	Comoros
Flag of the Democratic Republic of Congo	Democratic Republic of the Congo
Flag of the Republic of Congo	Republic of the Congo
Flag of Costa Rica	Costa Rica
Flag of Cote d'Ivoire	Cote d'Ivoire
Flag of Croatia	Croatia
Flag of Cuba	Cuba
Flag of Cyprus	Cyprus
Flag of Czech Republic	Czech Republic
 	D
Flag of Denmark	Denmark
Flag of Djibouti	Djibouti
Flag of Dominica	Dominica
Flag of Dominican Republic	Dominican Republic
 	E
Flag of Ecuador	Ecuador
Flag of Egypt	Egypt
Flag of El Salvador	El Salvador
Flag of Equatorial Guinea	Equatorial Guinea
Flag of Eritrea	Eritrea
Flag of Estonia	Estonia
Flag of Eswatini (formerly Swaziland)	Eswatini (formerly Swaziland)
Flag of Ethiopia	Ethiopia
 	F
Flag of Fiji	Fiji
Flag of Finland	Finland
Flag of France	France
 	G
Flag of Gabon	Gabon
Flag of Gambia	Gambia
Flag of Georgia	Georgia
Flag of Germany	Germany
Flag of Ghana	Ghana
Flag of Greece	Greece
Flag of Grenada	Grenada
Flag of Guatemala	Guatemala
Flag of Guinea	Guinea
Flag of Guinea-Bissau	Guinea-Bissau
Flag of Guyana	Guyana
 	H
Flag of Haiti	Haiti
Flag of Honduras	Honduras
Flag of Hungary	Hungary
 	I
Flag of Iceland	Iceland
Flag of India	India
Flag of Indonesia	Indonesia
Flag of Iran	Iran
Flag of Iraq	Iraq
Flag of Ireland	Ireland
Flag of Israel	Israel
Flag of Italy	Italy
 	J
Flag of Jamaica	Jamaica
Flag of Japan	Japan
Flag of Jordan	Jordan
 	K
Flag of Kazakhstan	Kazakhstan
Flag of Kenya	Kenya
Flag of Kiribati	Kiribati
Flag of Kosovo	Kosovo
Flag of Kuwait	Kuwait
Flag of Kyrgyzstan	Kyrgyzstan
 	L
Flag of Laos	Laos
Flag of Latvia	Latvia
Flag of Lebanon	Lebanon
Flag of Lesotho	Lesotho
Flag of Liberia	Liberia
Flag of Libya	Libya
Flag of Liechtenstein	Liechtenstein
Flag of Lithuania	Lithuania
Flag of Luxembourg	Luxembourg
Flag	Country
 	M
Flag of Macedonia	Macedonia (FYROM)
Flag of Madagascar	Madagascar
Flag of Malawi	Malawi
Flag of Malaysia	Malaysia
Flag of Maldives	Maldives
Flag of Mali	Mali
Flag of Malta	Malta
Flag of Marshall Islands	Marshall Islands
Flag of Mauritania	Mauritania
Flag of Mauritius	Mauritius
Flag of Mexico	Mexico
Flag of Micronesia	Micronesia
Flag of Moldova	Moldova
Flag of Monaco	Monaco
Flag of Mongolia	Mongolia
Flag of Montenegro	Montenegro
Flag of Morocco	Morocco
Flag of Mozambique	Mozambique
Flag of Myanmar (formerly Burma)	Myanmar (formerly Burma)
 	N
Flag of Namibia	Namibia
Flag of Nauru	Nauru
Flag of Nepal	Nepal
Flag of Netherlands	Netherlands
Flag of New Zealand	New Zealand
Flag of Nicaragua	Nicaragua
Flag of Niger	Niger
Flag of Nigeria	Nigeria
Flag of North Korea	North Korea
Flag of Norway	Norway
 	O
Flag of Oman	Oman
 	P
Flag of Pakistan	Pakistan
Flag of Palau	Palau
Flag of Palestine	Palestine
Flag of Panama	Panama
Flag of Papua New Guinea	Papua New Guinea
Flag of Paraguay	Paraguay
Flag of Peru	Peru
Flag of Philippines	Philippines
Flag of Poland	Poland
Flag of Portugal	Portugal
 	Q
Flag of Qatar	Qatar
 	R
Flag of Romania	Romania
Flag of Russia	Russia
Flag of Rwanda	Rwanda
 	S
Flag of Saint Kitts and Nevis	Saint Kitts and Nevis
Flag of Saint Lucia	Saint Lucia
Flag of Saint Vincent and the Grenadines	Saint Vincent and the Grenadines
Flag of Samoa	Samoa
Flag of San Marino	San Marino
Flag of Sao Tome and Principe	Sao Tome and Principe
Flag of Saudi Arabia	Saudi Arabia
Flag of Senegal	Senegal
Flag of Serbia	Serbia
Flag of Seychelles	Seychelles
Flag of Sierra Leone	Sierra Leone
Flag of Singapore	Singapore
Flag of Slovakia	Slovakia
Flag of Slovenia	Slovenia
Flag of Solomon Islands	Solomon Islands
Flag of Somalia	Somalia
Flag of South Africa	South Africa
Flag of South Korea	South Korea
Flag of South Sudan	South Sudan
Flag of Spain	Spain
Flag of Sri Lanka	Sri Lanka
Flag of Sudan	Sudan
Flag of Suriname	Suriname
Flag of Sweden	Sweden
Flag of Switzerland	Switzerland
Flag of Syria	Syria
 	T
Flag of Taiwan	Taiwan
Flag of Tajikistan	Tajikistan
Flag of Tanzania	Tanzania
Flag of Thailand	Thailand
Flag of Timor-Leste	Timor-Leste
Flag of Togo	Togo
Flag of Tonga	Tonga
Flag of Trinidad and Tobago	Trinidad and Tobago
Flag of Tunisia	Tunisia
Flag of Turkey	Turkey
Flag of Turkmenistan	Turkmenistan
Flag of Tuvalu	Tuvalu
 	U
Flag of Uganda	Uganda
Flag of Ukraine	Ukraine
Flag of United Arab Emirates	United Arab Emirates
Flag of United Kingdom	United Kingdom
Flag of United States of America	United States of America
Flag of Uruguay	Uruguay
Flag of Uzbekistan	Uzbekistan
 	V
Flag of Vanuatu	Vanuatu
Flag of Vatican City (Holy See)	Vatican City (Holy See)
Flag of Venezuela	Venezuela
Flag of Vietnam	Vietnam
 	Y
Flag of Yemen	Yemen
 	Z
Flag of Zambia	Zambia
Flag of Zimbabwe	Zimbabwe
HOW MANY COUNTRIES?
COUNTRIES OF THE WORLD
COUNTRIES BY CONTINENT
COUNTRIES OF EUROPE
COUNTRIES OF ASIA
COUNTRIES OF AFRICA
COUNTRIES OF NORTH AMERICA
COUNTRIES OF SOUTH AMERICA
COUNTRIES OF AUSTRALIA AND OCEANIA
UNION OF COUNTRIES
EUROPEAN UNION COUNTRIES
WORLD STATISTICS
WORLD'S LARGEST COUNTRIES
WORLD'S SMALLEST COUNTRIES
MOST POPULOUS COUNTRIES
WORLD'S RICHEST COUNTRIES
MOST TRADED CURRENCIES
GLOBAL EDUCATION
WORLD'S TOP UNIVERSITIES
BEST US ONLINE COLLEGES
FREE ONLINE COURSES
